111111111111111
10000000P000001


100000E00000001
110C00000000001
111111111111111
