111111111111111
100000P00000001
100000000000C01
10000E000000001
111111111111111





