1111111111111
0000000000
23
0000000000
123
